1111111111111111111111111111111
100000C00100100S0010000010000E1
1001111111001111001001111111001
10010000000000000000010000000S1
1001111001001001111111001111001
1P00000001001001001001001000001
1001001111111111001001111001111
1001000000000000001000000000001
1001111001111001001001111001111
100100S000001001000001000001001
1111001001111111001111001001001
100100100000000100100S001000001
1001001111111111001001111111111
10000010000010C00010000000000E1
1111001001111111001111001111111
1001001001000000001000000000001
1001001001111111001111111001111
1C00000000000001000001001000001
1001111001111001111111001001001
1001000S0000100100000C000001001
1111111111111111111111111111111
