1111111111111111111111111111111111111111111111111111
1P000000000000S000000000000S0000000C0000000000S00001
100000S0000S000000000000000000000000000000S00C000001
10S000000S0000000000C0000000S0000S0000000000000000S1
1C00S000S00000S000000000000000000000000S000000000001
100S0000000000000000000000000000000000000000S00S0001
10000000000S000000000S000000S00000S0000000000000S001
1S0000000000C0000S000000000000000000S000000000000001
10000000S00000000000000S000000S0S0000000S00000S00001
100000000000S0000S00000000000000000000000C0000000001
10000S000000000000000000000000000S000000000000000001
10000000000S0000S000000C0S0000000000000000000S000001
1000000000000000000000000000000000000C00000000000001
10S0000C000000000S000000000000S00000000000S0000C0001
100000000000S000000000S00000000000000000S00000000001
10000S000000000S0000000000000C0000000000000000000SE1
1111111111111111111111111111111111111111111111111111
