1111111111111111111111
1P00000000000000000001
100000000000000000S001
10000000C0000000000001
1000000000000000000001
1000011110000111100001
1000011110000111100001
1000011110000111100001
1000011110000111100001
1000000001111000000C01
1000000001111000000001
100000S001111000000001
1000000001111000000001
100C011111111111100001
1000011111111111100S01
1000011111111111100001
1000011111111111100001
1000011110000111100001
1000011110000111100001
1000011110C00111100001
1000011110000111100001
1000000000000000000001
1000000000000000000001
1000000000S00000000001
10000000000000000000E1
1111111111111111111111
