11111111111111111111
1000000000000C000001
100000000011111100S1
10000000011011111001
100C0000011111111001
1000000S011110000001
10000000011111100001
10010000111100000001
10011001111111000001
10011111111101000001
10011111111100000001
10001111111100000001
10000111111000000001
10000011110000000001
1000001101000S000001
10000010010000000001
100000110110000C0001
1P0000000000000000E1
11111111111111111111